_____H______
SSS_S_SSSS__
B___SBSM_S__
____SBS_BS__
_B__SSSBKS__
____P____S__
_TBT_____S__
_TTT__+-_B__
_________B__
BSSSSBBSSSB_
__n____M____
___<___>_S__
