_V__SBS__S__M________________V__SBS__S__M___________
____SSS_KSSSSSS_________________SSS_KSSSSSS_________
____MM___S______________________MM___S______________
__MMMM___S__n________________TBT_____S______________
_TBT_____S__________H___W____TTT__+-_B______________
MMMMMMMMMMMMMMMMMMMMMMMMMMMM__MMMM___S__n___________
MMMMMMMMMMMMMMMMMMMMMMMMMMMM_TBT_____S__________H___
MMMMMMMMMMMMMMMMMMMMMMMMMMMM_______________SSS_S_SSS
MMMMMMMMMMMMMMMMMMMMMMMMMMMM_V__SBS__S__M___________
MMMMMMMMMMMMMMMMMMMMMMMMMMMM____SSS_KSSSSSS_________
MMMMMMMMMMMMMMMMMMMMMMMMMMMM____MM___S______________
MMMMMMMMMMMMMMMMMMMMMMMMMMMM_TBT_____S____MMMMMM____
MMMMMMMMMMMMMMMMMMMMMMMMMMMM_TTT__+-_B______________
MMMMMMMMMMMMMMMMMMMMMMMMMMMM__MMMM___S__n___________
MMMMMMMMMMMMMMMMMMMMMMMMMMMM_TBT_____S__________H___
MMMMMMMMMMMMMMMMMMMMMMMMMMMM_______________SSS_S_SSS